$$$$$$$$$$$
$$$$$$$$$$$
$$$$$$$$$$$
$$$$$$$$$$$
$$$$$$$$$$$
$$$$$$$$$$$
$$$$$$$$$$$
$$$$$$$$$$$
$$$$$$$$$$$
###########
###########
###########
###     ###
##b     ###
###     ###
###########
###########
###########
"""""""""""
"""""""""""
"""""""""""
"""""""""""
"""""""""""
"""""""""""
"""""""""""
"""""""""""
"""""""""""
