$$$$$$$$$$$$$$$
$$$$$$$$$$$$$$$
$$$$$$$$$$$$$$$
$$$$$$$$$$$$$$$
$$$$$$$$$$$$$$$
$$$$$''''''$$$$
$$$$$'''  '$$$$
$$$$$''''''$$$$
$$$$$$$$$$$$$$$
$$$$$$$$$$$$$$$
$$$$$$$$$$$$$$$
$$$$$$$$$$$$$$$
$$$$$$$$$$$$$$$
###############
###############
###############
###############
###############
#####     #####
####b     #####
#####     #####
###############
###############
###############
###############
###############
"""""""""""""""
"""""""""""""""
"""""""""""""""
"""""""""""""""
"""""""""""""""
"""""""""""""""
"""""""""""""""
"""""""""""""""
"""""""""""""""
"""""""""""""""
"""""""""""""""
"""""""""""""""
"""""""""""""""
