$$$$$$$$$$$$$$$
$$$$$$$$$$$$$$$
$$$$$$$$$$$$$$$
$$$$$$$$$$$$$$$
$$$$$$$$$$$$$$$
$$$$$$$$$$$$$$$
$$$$$$$$$$$$$$$
$$$$$$$$$$$$$$$
$$$$$$$$$$$$$$$
$$$$$$$$$$$$$$$
$$$$$$$$$$$$$$$
$$$$$$$$$$$$$$$
$$$$$$$$$$$$$$$
###############
###############
###############
###############
###############
#####     #####
####b     #####
#####     #####
###############
###############
###############
###############
###############
"""""""""""""""
"""""""""""""""
"""""""""""""""
"""""""""""""""
"""""""""""""""
"""""""""""""""
"""""""""""""""
"""""""""""""""
"""""""""""""""
"""""""""""""""
"""""""""""""""
"""""""""""""""
"""""""""""""""
