""""""""""""""""
""""""""""""""""
""""""""""""""""
""""""""""""""""
""""""""""""""""
""""""""""""""""
""""""""""""""""
################
#              #
#              #
#              #
#              #
#              #
################
''''''''''''''''
''''''''''''''''
''''''''''''''''
''''''''''''''''
''''''''''''''''
''''''''''''''''
''''''''''''''''
