""""""""""""""""""""""""
""""""""""""""""""""""""
""""""""""""""""""""""""
""""""""""""""""""""""""
""""""""""""""""""""""""
""""""""""""""""""""""""
""""""""""""""""""""""""
""""""""""""""""""""""""
""""""""""""""""""""""""
########################
####        #       ####
###         #        ###
##          #         ##
#           #          #
##          #####     ##
###                  ###
####                ####
########################
''''''''''''''''''''''''
''''''''''''''''''''''''
''''''''''''''''''''''''
''''''''''''''''''''''''
''''''~'''''''''''''~'''
''''''''''''''''''''''''
''''''''''''''''''''''''
''''''''''''''''''''''''
''''''''''''''''''''''''
