#################
#################
#################
#################
#################
#################
!!!!!!!!!!!!!!!!!
!###############!
!#              !
!#              !
!#              !
!!!!!!!!!!!!!!!!!
#################
#################
#################
#################
#################
#################
