#################
#################
#################
#################
#################
#################
!!!!!!!!!!!!!!!!!
!    ##         !
!               !
!               !
!               !
!!!!!!!!!!!!!!!!!
#################
##'##############
##''''''''''''''#
#'''''''''''''''#
#'''''''''''''''#
###############'#
