##############################################################
#       #  ###########                                       #
#       #  ##################                                #
#       #                                                    #
#       #  ##################                                #
#       #  ###########                                       #
#       #          ###                                       #
#       #  ##      ###                                       #
#       #  ##      ###                                       #
#       #  ##      ###                                       #
#       #  ##      ###                                       #
#############      ###########################################
##############################################################
##############################################################
##############################################################
##############################################################
##############################################################
##############################################################
##############################################################
##############################################################
##############################################################
##############################################################
##############################################################
##############################################################
##############################################################
##############################################################
##############################################################
##############################################################
##############################################################
##############################################################
##############################################################
##############################################################
##############################################################
##############################################################
##############################################################
##############################################################
##############################################################
##############################################################
##############################################################
##############################################################
##############################################################
##############################################################
##############################################################
##############################################################
##############################################################
##############################################################
##############################################################
##############################################################
##############################################################
##############################################################
##############################################################
##############################################################
##############################################################
##############################################################
##############################################################
##############################################################
#          ###########                                       #
#          ###########      #                                #
#                                                            #
#          ###########      #                                #
#          ###########                                       #
#                  ###                                       #
#          ##      ###                                       #
#          ##      ###                                       #
#          ##      ###                                       #
#          ##      ###                                       #
###### ######      ###########################################
######                                              # ########
###### ######      ###     # ###   #  # ### ### ##### ########
###### #    #      ######### ###   #    ### # # #   # ########
#      #    #                  #   ## ###   # # #   # ########
#      ###################     #   ## ######### ##### ########
#                        #     #   ## #               ########
#      ###         ##### #     #   ## # #######   ##### ######
#      ##             ## #     #   ## # # ####### #     #    #
#      ##           # ## #     #   ## # #         #     #  ###
#### # ## #######   # ##   # ######## # # ###############  ###
####      #     #   # ###### ######## # #                  ###
######  ###     #   # #               # ################## ###
####### ##      #   # ## #           ##                      #
#######  #      #   # ## #           #########################
######## ##     #   # ## #           #########################
########  #     #   # ## #           #########################
#         ##    #   # ## #           #########################
#          #    # ###    #           #########################
#          ##   #  ## ####           #########################
#           #  ##       ##           #########################
#         # # ##  #####  #                ####################
#         # ###  #     #  ## ### #     ## ####################
#         #  #  #       #  # # # #    #   ####################
#         ##   #         #   ###  #  #    ####################
#         ##    #       #          ###    ####################
#                #     #    ###     ###   ####################
#          ##     #####    ####     #  #  ####################
#          ## #         # #####    #    # ####################
########## #   #          #####  ##     # ####################
########## #############  #####           ####################
######                      ###         ######################
###### ### #############  # ##################################
######   #      ######### # ##################################
######## #    # ######### # ##################################
######## # ## # #########   ##################################
#####    # ## # ##############################################
##### ####    # ##############################################
##### ######### ##############################################
##### ######### ##############################################
##### ######### ##############################################
##### ######### ##############################################
#####           ##############################################
##############################################################
""""""""""""""""""""""""""""""""""""""""""""""""""""""""""""""
""""""""""""""""""""""""""""""""""""""""""""""""""""""""""""""
""""""""""""""""""""""""""""""""""""""""""""""""""""""""""""""
""""""""""""""""""""""""""""""""""""""""""""""""""""""""""""""
""""""""""""""""""""""""""""""""""""""""""""""""""""""""""""""
""""""""""""""""""""""""""""""""""""""""""""""""""""""""""""""
""""""""""""""""""""""""""""""""""""""""""""""""""""""""""""""
""""""""""""""""""""""""""""""""""""""""""""""""""""""""""""""
""""""""""""""""""""""""""""""""""""""""""""""""""""""""""""""
""""""""""""""""""""""""""""""""""""""""""""""""""""""""""""""
""""""""""""""""""""""""""""""""""""""""""""""""""""""""""""""
""""""""""""""""""""""""""""""""""""""""""""""""""""""""""""""
""""""""""""""""""""""""""""""""""""""""""""""""""""""""""""""
""""""""""""""""""""""""""""""""""""""""""""""""""""""""""""""
""""""""""""""""""""""""""""""""""""""""""""""""""""""""""""""
""""""""""""""""""""""""""""""""""""""""""""""""""""""""""""""
""""""""""""""""""""""""""""""""""""""""""""""""""""""""""""""
""""""""""""""""""""""""""""""""""""""""""""""""""""""""""""""
""""""""""""""""""""""""""""""""""""""""""""""""""""""""""""""
""""""""""""""""""""""""""""""""""""""""""""""""""""""""""""""
""""""""""""""""""""""""""""""""""""""""""""""""""""""""""""""
""""""""""""""""""""""""""""""""""""""""""""""""""""""""""""""
""""""""""""""""""""""""""""""""""""""""""""""""""""""""""""""
""""""""""""""""""""""""""""""""""""""""""""""""""""""""""""""
""""""""""""""""""""""""""""""""""""""""""""""""""""""""""""""
""""""""""""""""""""""""""""""""""""""""""""""""""""""""""""""
""""""""""""""""""""""""""""""""""""""""""""""""""""""""""""""
""""""""""""""""""""""""""""""""""""""""""""""""""""""""""""""
""""""""""""""""""""""""""""""""""""""""""""""""""""""""""""""
""""""""""""""""""""""""""""""""""""""""""""""""""""""""""""""
""""""""""""""""""""""""""""""""""""""""""""""""""""""""""""""
""""""""""""""""""""""""""""""""""""""""""""""""""""""""""""""
""""""""""""""""""""""""""""""""""""""""""""""""""""""""""""""
""""""""""""""""""""""""""""""""""""""""""""""""""""""""""""""
""""""""""""""""""""""""""""""""""""""""""""""""""""""""""""""
""""""""""""""""""""""""""""""""""""""""""""""""""""""""""""""
""""""""""""""""""""""""""""""""""""""""""""""""""""""""""""""
""""""""""""""""""""""""""""""""""""""""""""""""""""""""""""""
""""""""""""""""""""""""""""""""""""""""""""""""""""""""""""""
""""""""""""""""""""""""""""""""""""""""""""""""""""""""""""""
""""""""""""""""""""""""""""""""""""""""""""""""""""""""""""""
""""""""""""""""""""""""""""""""""""""""""""""""""""""""""""""
""""""""""""""""""""""""""""""""""""""""""""""""""""""""""""""
""""""""""""""""""""""""""""""""""""""""""""""""""""""""""""""
""""""""""""""""""""""""""""""""""""""""""""""""""""""""""""""
""""""""""""""""""""""""""""""""""""""""""""""""""""""""""""""
""""""""""""""""""""""""""""""""""""""""""""""""""""""""""""""
""""""""""""""""""""""""""""""""""""""""""""""""""""""""""""""
""""""""""""""""""""""""""""""""""""""""""""""""""""""""""""""
""""""""""""""""""""""""""""""""""""""""""""""""""""""""""""""
""""""""""""""""""""""""""""""""""""""""""""""""""""""""""""""
""""""""""""""""""""""""""""""""""""""""""""""""""""""""""""""
""""""""""""""""""""""""""""""""""""""""""""""""""""""""""""""
""""""""""""""""""""""""""""""""""""""""""""""""""""""""""""""
""""""""""""""""""""""""""""""""""""""""""""""""""""""""""""""
