"""""""""""""""""
"""""""""""""""""
"""""""""""""""""
"""""""""""""""""
"""""""""""""""""
"""""""""""""""""
"""""""""""""""""
"""""""""""""""""
"""""""""""""""""
"""""""""""""""""
"""""""""""""""""
"""""""""""""""""
"""""""""""""""""
#################
#               #
#          #    #
#          #    #
#          # ####
#          # #  #
#               #
#          # #  #
#          # ####
#          #    #
#          #    #
#               #
#################
'''''''''''''''''
'''''''''''''''''
'''''''''''''''''
'''''''''''''''''
'''''''''''''''''
'''''''''''''''''
'''''''''''''''''
'''''''''''''''''
'''''''''''''''''
'''''''''''''''''
'''''''''''''''''
'''''''''''''''''
'''''''''''''''''
