#####################
############        #
############        #
############        #
############        #
#####################
#####################
#####################
#####################
#####################
#####################
#                   #
#                   #
#                   #
#                   #
#                   #
#                   #
#                   #
#                   #
#####################
"""""""""""""""""""""
"""""""""""""       "
"""""""""""""       "
""""""""~""""       "
"""""""""""""""""""""
"""""""""""""""""""""
"""""""""""""""""""""
"""""""""""""""""""""
"""""""""""""""""""""
"""""""""""""""""""""
