"""""""""""""""""""""""""""""
"""""""""""""""""""""""""""""
"""""""""""""""""""""""""""""
"""""""""""""""""""""""""""""
"""""""""""""""""""""""""""""
"""""""""""""""""""""""""""""
"""""""""""""""""""""""""""""
#############################
#                        #  #
#             #          #  #
#             #          #  #
#             ############  #
#                           #
#############################
'''''''''''''''''''''''''''''
'''''''''''''''''''''''''''''
'''''''''''''''''''''''''''''
'''''''''''''''''''''''''''''
'''''''''''''''''''''''''''''
'''''''''''''''''''''''''''''
'''''''''''''''''''''''''''''
