"""""""""""""""""""""""""""""
"""""""""""""""""""""""""""""
"""""""""""""""""""""""""""""
"""""""""""""""""""""""""""""
"""""""""""""""""""""""""""""
"""""""""""""""""""""""""""""
"""""""""""""""""""""""""""""
#############################
#                           #
#                           #
#                           #
#            ########    ####
#                           #
#############################
'''''''''''''''''''''''''''''
'''''''''''''''''''''''''''''
'''''''''''''''''''''''''''''
'''''''''''''''''''''''''''''
'''''''''''''''''''''''''''''
'''''''''''''''''''''''''''''
'''''''''''''''''''''''''''''
