"""""""""""""""""""
"""""""""""""""""""
"""""""""""""""""""
"""""""""""""""""""
"""""""""""""""""""
"""""""""""""""""""
"""""""""""""""""""
###################
#                 #
#               # #
#               # #
#               # #
#               # #
###################
'''''''''''''''''''
'''''''''''''''''''
'''''''''''''''''''
'''''''''''''''''''
'''''''''''''''''''
'''''''''''''''''''
'''''''''''''''''''
