################
################
################
################
################
################
################
################
#              #
#          #####
#              #
#          #####
#              #
################
################
################
################
################
################
################
################
