#################
#################
#################
#################
#################
#################
!!!!!!!!!!!!!!!!!
!###############!
!#             #!
!#     #    #  #!
!########  ##  #!
!!!!!!!!!!!!!!!!!
#################
##'##############
##''''''''''''''#
#'''''''''''''''#
#'''''''''''''''#
###############'#
