"""""""""""""""""""""""""""
"""""""""""""""""""""""""""
"""""""""""""""""""""""""""
"""""""""""""""""""""""""""
"""""""""""""""""""""""""""
"""""""""""""""""""""""""""
"""""""""""""""""""""""""""
"""""""""""""""""""""""""""
"""""""""""""""""""""""""""
"""""""""""""""""""""""""""
"""""""""""""""""""""""""""
"""""""""""""""""""""""""""
"""""""""""""""""""""""""""
###########################
#                         #
#              # # # #    #
#              # # # #    #
#              # # # # ####
#              # # # # #  #
#                         #
#              # # # # #  #
#              # # # # ####
#              # # # #    #
#              # # # #    #
#                         #
###########################
'''''''''''''''''''''''''''
'''''''''''''''''''''''''''
'''''''''''''''''''''''''''
'''''''''''''''''''''''''''
'''''''''''''''''''''''''''
'''''''''''''''''''''''''''
'''''''''''''''''''''''''''
'''''''''''''''''''''''''''
'''''''''''''''''''''''''''
'''''''''''''''''''''''''''
'''''''''''''''''''''''''''
'''''''''''''''''''''''''''
'''''''''''''''''''''''''''
