!!!!!!!!!!!!!!!!!!!!!!!!!!
!""""""""""""""""""""""""!
!""""""""""""""""""""""""!
!""""""""""""""""""""""""!
!""""""""""""""""""""""""!
!""""""""""""""""""""~"""!
!""""""""""""""""""""""""!
!""""""""""""""""""""""""!
!""""""""""""""""""""""""!
!""""""""""""""""""""""""!
!!!!!!!!!!!!!!!!!!!!!!!!!!
!!!!!!!!!!!!!!!!!!!!!!!!!!
!########################!
!###   ##               #!
!##     #               #!
!#      ##              #!
!#                      #!
!#      ##              #!
!##     #               #!
!###   ##               #!
!########################!
!!!!!!!!!!!!!!!!!!!!!!!!!!
!!!!!!!!!!!!!!!!!!!!!!!!!!
!''''''''''''''''''''''''!
!''''''''''''''''''''''''!
!''''''''''''''''''''''''!
!''''''''''''''''''''''''!
!''''''''''''''''''''''''!
!''''''''''''''''''''''''!
!''''''''''''''''''''''''!
!''''''''''''''''''''''''!
!''''''''''''''''''''''''!
!!!!!!!!!!!!!!!!!!!!!!!!!!
