!!!!!!!!!!!!!!!!!!!!!!!!!!
!""""""""""""""""""""""""!
!""""""""""""""""""""""""!
!""""""""""""""""""""""""!
!""""""""""""""""""""""""!
!""""""""""""""""""""~"""!
!""""""""""""""""""""""""!
!""""""""""""""""""""""""!
!""""""""""""""""""""""""!
!""""""""""""""""""""""""!
!!!!!!!!!!!!!!!!!!!!!!!!!!
!!!!!!!!!!!!!!!!!!!!!!!!!!
!########################!
!#          #           #!
!#                      #!
!#          #           #!
!############           #!
!#          #           #!
!#                      #!
!#          #           #!
!########################!
!!!!!!!!!!!!!!!!!!!!!!!!!!
!!!!!!!!!!!!!!!!!!!!!!!!!!
!''''''''''''''''''''''''!
!''''''''''''''''''''''''!
!''''''''''''''''''''''''!
!''''''''''''''''''''''''!
!''''''''''''''''''''''''!
!''''''''''''''''''''''''!
!''''''''''''''''''''''''!
!''''''''''''''''''''''''!
!''''''''''''''''''''''''!
!!!!!!!!!!!!!!!!!!!!!!!!!!
