###############################################################################
####################################       ####################################
####################################       ####################################
####################################       ####################################
####################################       ####################################
####################################       ####################################
####################################       ####################################
####################################       ####################################
####################################       ####################################
####################################       ####################################
####################################       ####################################
####################################       ####################################
####################################       ####################################
####################################       ####################################
####################################       ####################################
####################################       ####################################
####################################       ####################################
####################################       ####################################
#################################             #################################
###############################                 ###############################
##############################                   ##############################
#############################                     #############################
############################                       ############################
###########################                         ###########################
##########################                           ##########################
##########################                           ##########################
#########################                             #########################
#########################                             #########################
#########################                             #########################
########################           #       #           ########################
########################                               ########################
########################                               ########################
########################                               ########################
########################                               ########################
########################                               ########################
########################           #       #           ########################
#########################                             #########################
#########################                             #########################
#########################                             #########################
##########################                           ##########################
##########################                           ##########################
###########################                         ###########################
############################                       ############################
#############################                     #############################
##############################                   ##############################
###############################                 ###############################
#################################             #################################
####################################       ####################################
###############################################################################
###############################################################################
###############################################################################
###############################################################################
###############################################################################
###############################################################################
###############################################################################
###############################################################################
###############################################################################
###############################################################################
###############################################################################
####################################       ####################################
#################################### #   # ####################################
####################################       ####################################
####################################       ####################################
#################################### #   # ####################################
####################################       ####################################
####################################       ####################################
#################################### #   # ####################################
####################################       ####################################
####################################       ####################################
#################################### #   # ####################################
####################################       ####################################
####################################       ####################################
#################################### #   # ####################################
####################################       ####################################
####################################       ####################################
#################################### #   # ####################################
#################################             #################################
###############################                 ###############################
##############################                   ##############################
#############################                     #############################
############################                       ############################
###########################                         ###########################
##########################                           ##########################
##########################                           ##########################
#########################                             #########################
#########################                             #########################
#########################                             #########################
########################           #       #           ########################
########################           #       #           ########################
########################           #       #           ########################
########################           #       #           ########################
########################           #       #           ########################
########################           #       #           ########################
########################           #########           ########################
#########################                             #########################
#########################                             #########################
#########################                             #########################
##########################                           ##########################
##########################                           ##########################
###########################                         ###########################
############################                       ############################
#############################                     #############################
##############################                   ##############################
###############################                 ###############################
#################################             #################################
####################################       ####################################
###############################################################################
###############################################################################
###############################################################################
###############################################################################
###############################################################################
###############################################################################
###############################################################################
###############################################################################
###############################################################################
###############################################################################
"""""""""""""""""""""""""""""""""""""""""""""""""""""""""""""""""""""""""""""""
"""""""""""""""""""""""""""""""""""""""""""""""""""""""""""""""""""""""""""""""
"""""""""""""""""""""""""""""""""""""""""""""""""""""""""""""""""""""""""""""""
"""""""""""""""""""""""""""""""""""""""""""""""""""""""""""""""""""""""""""""""
"""""""""""""""""""""""""""""""""""""""""""""""""""""""""""""""""""""""""""""""
"""""""""""""""""""""""""""""""""""""""""""""""""""""""""""""""""""""""""""""""
"""""""""""""""""""""""""""""""""""""""""""""""""""""""""""""""""""""""""""""""
"""""""""""""""""""""""""""""""""""""""""""""""""""""""""""""""""""""""""""""""
"""""""""""""""""""""""""""""""""""""""""""""""""""""""""""""""""""""""""""""""
"""""""""""""""""""""""""""""""""""""""""""""""""""""""""""""""""""""""""""""""
"""""""""""""""""""""""""""""""""""""""""""""""""""""""""""""""""""""""""""""""
"""""""""""""""""""""""""""""""""""""""""""""""""""""""""""""""""""""""""""""""
"""""""""""""""""""""""""""""""""""""""""""""""""""""""""""""""""""""""""""""""
"""""""""""""""""""""""""""""""""""""""""""""""""""""""""""""""""""""""""""""""
"""""""""""""""""""""""""""""""""""""""""""""""""""""""""""""""""""""""""""""""
"""""""""""""""""""""""""""""""""""""""""""""""""""""""""""""""""""""""""""""""
"""""""""""""""""""""""""""""""""""""""""""""""""""""""""""""""""""""""""""""""
"""""""""""""""""""""""""""""""""""""""""""""""""""""""""""""""""""""""""""""""
"""""""""""""""""""""""""""""""""     '''     """""""""""""""""""""""""""""""""
"""""""""""""""""""""""""""""""       '''       """""""""""""""""""""""""""""""
""""""""""""""""""""""""""""""   """"""""""""    """"""""""""""""""""""""""""""
"""""""""""""""""""""""""""""   """""""""""""""   """""""""""""""""""""""""""""
""""""""""""""""""""""""""""   """""""""""""""""   """"""""""""""""""""""""""""
"""""""""""""""""""""""""""   """""""""""""""""""   """""""""""""""""""""""""""
""""""""""""""""""""""""""   """""""""""""""""""""   """"""""""""""""""""""""""
""""""""""""""""""""""""""  """""""""""""""""""""""  """"""""""""""""""""""""""
"""""""""""""""""""""""""   """""""""""""""""""""""   """""""""""""""""""""""""
"""""""""""""""""""""""""  """""""""""""""""""""""""  """""""""""""""""""""""""
"""""""""""""""""""""""""  """""""""""""""""""""""""  """""""""""""""""""""""""
""""""""""""""""""""""""   """""""""""""""""""""""""   """"""""""""""""""""""""
""""""""""""""""""""""""  """""""""""""""""""""""""""  """"""""""""""""""""""""
""""""""""""""""""""""""  """""""""""""""""""""""""""  """"""""""""""""""""""""
""""""""""""""""""""""""  """""""""""""~"""""""""""""  """"""""""""""""""""""""
""""""""""""""""""""""""  """""""""""""""""""""""""""  """"""""""""""""""""""""
""""""""""""""""""""""""  """""""""""""""""""""""""""  """"""""""""""""""""""""
""""""""""""""""""""""""   """""""""""""""""""""""""   """"""""""""""""""""""""
"""""""""""""""""""""""""  """""""""""""""""""""""""  """""""""""""""""""""""""
"""""""""""""""""""""""""  """""""""""""""""""""""""  """""""""""""""""""""""""
"""""""""""""""""""""""""   """""""""""""""""""""""   """""""""""""""""""""""""
""""""""""""""""""""""""""  """""""""""""""""""""""  """"""""""""""""""""""""""
""""""""""""""""""""""""""   """""""""""""""""""""   """"""""""""""""""""""""""
"""""""""""""""""""""""""""   """""""""""""""""""   """""""""""""""""""""""""""
""""""""""""""""""""""""""""   """""""""""""""""   """"""""""""""""""""""""""""
"""""""""""""""""""""""""""""   """""""""""""""   """""""""""""""""""""""""""""
""""""""""""""""""""""""""""""    """""""""""    """"""""""""""""""""""""""""""
"""""""""""""""""""""""""""""""      """""      """""""""""""""""""""""""""""""
"""""""""""""""""""""""""""""""""             """""""""""""""""""""""""""""""""
""""""""""""""""""""""""""""""""""""       """"""""""""""""""""""""""""""""""""
"""""""""""""""""""""""""""""""""""""""""""""""""""""""""""""""""""""""""""""""
"""""""""""""""""""""""""""""""""""""""""""""""""""""""""""""""""""""""""""""""
"""""""""""""""""""""""""""""""""""""""""""""""""""""""""""""""""""""""""""""""
"""""""""""""""""""""""""""""""""""""""""""""""""""""""""""""""""""""""""""""""
"""""""""""""""""""""""""""""""""""""""""""""""""""""""""""""""""""""""""""""""
"""""""""""""""""""""""""""""""""""""""""""""""""""""""""""""""""""""""""""""""
"""""""""""""""""""""""""""""""""""""""""""""""""""""""""""""""""""""""""""""""
"""""""""""""""""""""""""""""""""""""""""""""""""""""""""""""""""""""""""""""""
"""""""""""""""""""""""""""""""""""""""""""""""""""""""""""""""""""""""""""""""
"""""""""""""""""""""""""""""""""""""""""""""""""""""""""""""""""""""""""""""""
