""""""""""""""""""""""""
""""""""""""""""""""""""
""""""""""""""""""""""""
""""""""""""""""""""""""
""""""~"""""""""""""~"""
""""""""""""""""""""""""
""""""""""""""""""""""""
""""""""""""""""""""""""
""""""""""""""""""""""""
########################
###   ##               #
##     #               #
#      ##              #
#                      #
#      ##              #
##     #               #
###   ##               #
########################
''''''''''''''''''''''''
''''''''''''''''''''''''
''''''''''''''''''''''''
''''''''''''''''''''''''
''''''''''''''''''''''''
''''''''''''''''''''''''
''''''''''''''''''''''''
''''''''''''''''''''''''
''''''''''''''''''''''''
