####################################
####################################
####################################
### #$$$$$$$#            #       ###
### #$$$$$$$#            #       ###
### #$$$$$$$#            #       ###
### #########                    ###
###                             ####
###              #               ###
###                             ####
###                              ###
###      ###             #       ###
###      #               #       ###
###      #               #       ###
####################################
####################################
####################################
####################################
####################################
####################################
### #       #           ###      ###
### #       #           ###      ###
### #       #           #%#      ###
### #### ####                    ###
###             ###             ####
###             ###              d##
###             ###             ####
###                              ###
###     #%#             #%#      ###
###     ###             ###      ###
###     ###             ###      ###
####################################
####################################
####################################
""""""""""""""""""""""""""""""""""""
""""""""""""""""""""""""""""""""""""
""""""""""""""""""""""""""""""""""""
""""""""""""""""""""""""""""""""""""
""""""""""""""""""""""""""""""""""""
""""""""""""""""""""""""""""""""""""
""""""""""""""""""""""""""""""""""""
""""""""""""""""""""""""""""""""""""
""""""""""""""""""""""""""""""""""""
""""""""""""""""""""""""""""""""""""
""""""""""""""""""""""""""""""""""""
""""""""""""""""""""""""""""""""""""
""""""""""""""""""""""""""""""""""""
""""""""""""""""""""""""""""""""""""
""""""""""""""""""""""""""""""""""""
""""""""""""""""""""""""""""""""""""
""""""""""""""""""""""""""""""""""""
