#########################################
#########################################
#########################################
#########################################
#########################################
######      #$$$$$#   #$$$$# ###    #####
######      #$$$$$#   #$$$$# ###    #####
######      #######   ###### ###   ######
######                             ######
######                              #####
######                              #####
######                              #####
######                             ######
###### #####         ##            ######
###### #####  #%##   ####   ###     #####
###### #####  ####   ####   ###     #####
#########################################
######                             !#####
#########################################
#########################################
#########################################
#########################################
#########################################
#########################################
#########################################
#########################################
#########################################
#########################################
######      #     #   #    # ###    #####
######      #     #   #    # ###    #####
######      ### ###   ##  ## #%#   ######
######                             ######
#####'                              #####
#####'                              d####
#####'                              #####
######                             ######
###### ### # #####%# ##     #%#    ######
###### ###%# ####### ##%#   ###     #####
######    ## ####### ####   ###     #####
######### ###############################
######                             !#####
#########################################
#########################################
#########################################
#########################################
#########################################
"""""""""""""""""""""""""""""""""""""""""
"""""""""""""""""""""""""""""""""""""""""
"""""""""""""""""""""""""""""""""""""""""
"""""""""""""""""""""""""""""""""""""""""
"""""""""""""""""""""""""""""""""""""""""
"""""""""""""'''''"""""''''"""""""""""""
"""""""""""""'''''"""""''''"""""""""""""
"""""""""""""""'""""""""''""""""""""""""
"""""""""""""""""""""""""""""""""""""""""
"""""""""""""""""""""""""""""""""""""""""
"""""""""""""""""""""""""""""""""""""""""
"""""""""""""""""""""""""""""""""""""""""
"""""""""""""""""""""""""""""""""""""""""
"""""""""""""""""""""""""""""""""""""""""
"""""""""""""""""""""""""""""""""""""""""
"""""""""""""""""""""""""""""""""""""""""
"""""""""""""""""""""""""""""""""""""""""
"""""""""""""""""""""""""""""""""""""""""
"""""""""""""""""""""""""""""""""""""""""
"""""""""""""""""""""""""""""""""""""""""
"""""""""""""""""""""""""""""""""""""""""
"""""""""""""""""""""""""""""""""""""""""
"""""""""""""""""""""""""""""""""""""""""
