########################################
########################################
########################################
########################################
########################################
##### #$$$$$#              #       #####
##### #$$$$$#              #       #####
##### #######              #       #####
#####                              #####
#####              #              ######
#####              #               #####
#####              #              ######
#####              #               #####
#####      ###     #       #       #####
#####      #               #       #####
#####      #               #       #####
########################################
########################################
########################################
########################################
########################################
########################################
########################################
########################################
########################################
########################################
##### #     #             ###      #####
##### #     #             ###      #####
##### ### ###             #%#      #####
#####                              #####
#####              #              ######
#####                              d####
#####                             ######
#####                              #####
#####     #%#      #      #%#      #####
#####     ###             ###      #####
#####     ###             ###      #####
########################################
########################################
########################################
########################################
########################################
""""""""""""""""""""""""""""""""""""""""
""""""""""""""""""""""""""""""""""""""""
""""""""""""""""""""""""""""""""""""""""
""""""""""""""""""""""""""""""""""""""""
""""""""""""""""""""""""""""""""""""""""
""""""""""""""""""""""""""""""""""""""""
""""""""""""""""""""""""""""""""""""""""
""""""""""""""""""""""""""""""""""""""""
""""""""""""""""""""""""""""""""""""""""
""""""""""""""""""""""""""""""""""""""""
""""""""""""""""""""""""""""""""""""""""
""""""""""""""""""""""""""""""""""""""""
""""""""""""""""""""""""""""""""""""""""
""""""""""""""""""""""""""""""""""""""""
""""""""""""""""""""""""""""""""""""""""
""""""""""""""""""""""""""""""""""""""""
""""""""""""""""""""""""""""""""""""""""
""""""""""""""""""""""""""""""""""""""""
""""""""""""""""""""""""""""""""""""""""
""""""""""""""""""""""""""""""""""""""""
""""""""""""""""""""""""""""""""""""""""
