########################################
########################################
########################################
########################################
########################################
##### #$$$$$#              #       #####
##### #$$$$$#              #       #####
##### #######              #       #####
#####                              #####
#####              #              ######
#####              #               #####
#####              #              ######
#####              #               #####
#####              #       #       #####
#####  #%##                #       #####
#####  ####                #       #####
########################################
########################################
########################################
########################################
########################################
########################################
########################################
########################################
########################################
########################################
##### #     #             ###      #####
##### #     #             ###      #####
##### ### ###             #%#      #####
#####                              #####
#####              #              ######
#####                              d####
#####                             ######
#####                              #####
##### #####%#      #      #%#      #####
##### #######             ###      #####
##### #######             ###      #####
########################################
########################################
########################################
########################################
########################################
""""""""""""""""""""""""""""""""""""""""
""""""""""""""""""""""""""""""""""""""""
""""""""""""""""""""""""""""""""""""""""
""""""""""""""""""""""""""""""""""""""""
""""""""""""""""""""""""""""""""""""""""
"""""""'''''""""""""""""""""""""""""""""
"""""""'''''""""""""""""""""""""""""""""
"""""""""'""""""""""""""""""""""""""""""
""""""""""""""""""""""""""""""""""""""""
""""""""""""""""""""""""""""""""""""""""
""""""""""""""""""""""""""""""""""""""""
""""""""""""""""""""""""""""""""""""""""
""""""""""""""""""""""""""""""""""""""""
""""""""""""""""""""""""""""""""""""""""
""""""""""""""""""""""""""""""""""""""""
""""""""""""""""""""""""""""""""""""""""
""""""""""""""""""""""""""""""""""""""""
""""""""""""""""""""""""""""""""""""""""
""""""""""""""""""""""""""""""""""""""""
""""""""""""""""""""""""""""""""""""""""
""""""""""""""""""""""""""""""""""""""""
