####################################
####################################
####################################
### #$$$$$$$#            #       ###
### #$$$$$$$#            #       ###
### #$$$$$$$#            #       ###
### #########                    ###
###              #              ####
###              #               ###
###              #              ####
###              #               ###
###      ###     #       #       ###
###      #               #       ###
###      #               #       ###
####################################
####################################
####################################
####################################
####################################
####################################
### #       #           ###      ###
### #       #           ###      ###
### #       #           #%#      ###
### #### ####                    ###
###              #              ####
###                              d##
###                             ####
###                              ###
###     #%#      #      #%#      ###
###     ###             ###      ###
###     ###             ###      ###
####################################
####################################
####################################
""""""""""""""""""""""""""""""""""""
""""""""""""""""""""""""""""""""""""
""""""""""""""""""""""""""""""""""""
""""""""""""""""""""""""""""""""""""
""""""""""""""""""""""""""""""""""""
""""""""""""""""""""""""""""""""""""
""""""""""""""""""""""""""""""""""""
""""""""""""""""""""""""""""""""""""
""""""""""""""""""""""""""""""""""""
""""""""""""""""""""""""""""""""""""
""""""""""""""""""""""""""""""""""""
""""""""""""""""""""""""""""""""""""
""""""""""""""""""""""""""""""""""""
""""""""""""""""""""""""""""""""""""
""""""""""""""""""""""""""""""""""""
""""""""""""""""""""""""""""""""""""
""""""""""""""""""""""""""""""""""""
