################################
################################
################################
################################
################################
################################
################################
################################
################################
################################
################################
################################
!!!!!!!!!!!!!!!!!!!!!!!!!!!!!!!!
!!!!!!!!!!!!!!!!!!!!!!!!!!!!!!!!
!!                            !!
!!                            !!
!!                            !!
!!                            !!
!!                            !!
!!                            !!
!!                            !!
!!                            !!
!!!!!!!!!!!!!!!!!!!!!!!!!!!!!!!!
!!!!!!!!!!!!!!!!!!!!!!!!!!!!!!!!
################################
################################
################################
################################
################################
################################
################################
################################
################################
################################
################################
################################
