$$$$$$$$$$$$$$$$$$$$$$$$$$$$$$$$$$$
$$$$$$$$$$$$$$$$$$$$$$$$$$$$$$$$$$$
$$$$$$$$$$$$$$$$$$$$$$$$$$$$$$$$$$$
$$$$$$$$$$$$$$$$$$$$$$$$$$$$$$$$$$$
$$$$$$$$$$$$$$$$$$$$$$$$$$$$$$$$$$$
$$$$$$$$$$$$$$$$$$$$$$$$$$$$$$$$$$$
$$$$$$$$$$$$$$$$$$$$$$$$$$$$$$$$$$$
$$$$$$$$$$$$$$$$$$$$$$$$$$$$$$$$$$$
$$$$$$$$$$$$$$$$$$$$$$$$$$$$$$$$$$$
$$$$$$$$$$$$$$$$$$$$$$$$$$$$$$$$$$$
$$$$$$$$$$$$$$$$$$$$$$$$$$$$$$$$$$$
$$$$$$$$$$$$$$$$$$$$$$$$$$$$$$$$$$$
$$$$$$$$$$$$$$$$$$$$$$$$$$$$$$$$$$$
###################################
###################################
########################### #######
###              #########   ######
###    # ####### ########     #####
###      #     # #######       ####
##c      a     #                ###
###      #     # #######       ####
###    # ####### ########     #####
###              #########   ######
########################### #######
###################################
###################################
"""""""""""""""""""""""""""""""""""
"""""""""""""""""""""""""""""""""""
"""""""""""""""""""""""""""""""""""
"""""""""""""""""""""""""""""""""""
"""""""""""""""""""""""""""""""""""
"""""""""""""""""""""""""""""""""""
"""""""""""""""""""""""""""""""""""
"""""""""""""""""""""""""""""""""""
"""""""""""""""""""""""""""""""""""
"""""""""""""""""""""""""""""""""""
"""""""""""""""""""""""""""""""""""
"""""""""""""""""""""""""""""""""""
"""""""""""""""""""""""""""""""""""
