$$$$$$$$$$$$$$$$$$$$$$$$$$$$$$$
$$$$$$$$$$$$$$$$$$$$$$$$$$$$$$$
$$$$$$$$$$$$$$$$$$$$$$$$$$$$$$$
$$$$$$$$$$$$$$$$$$$$$$$$$$$$$$$
$$$$$$$$$$$$$$$$$$$$$$$$$$$$$$$
$$$$$$$$$$$$$$$$$$$$$$$$$$$$$$$
$$$$$$$$$$$$$$$$$$$$$$$$$$$$$$$
$$$$$$$$$$$$$$$$$$$$$$$$$$$$$$$
$$$$$$$$$$$$$$$$$$$$$$$$$$$$$$$
$$$$$$$$$$$$$$$$$$$$$$$$$$$$$$$
$$$$$$$$$$$$$$$$$$$$$$$$$$$$$$$
###############################
######################### #####
#              #########   ####
#    # ####### ########     ###
#      #     # #######       ##
c      a     #                #
#      #     # #######       ##
#    # ####### ########     ###
#              #########   ####
######################### #####
###############################
"""""""""""""""""""""""""""""""
"""""""""""""""""""""""""""""""
"""""""""""""""""""""""""""""""
"""""""""""""""""""""""""""""""
"""""""""""""""""""""""""""""""
"""""""""""""""""""""""""""""""
"""""""""""""""""""""""""""""""
"""""""""""""""""""""""""""""""
"""""""""""""""""""""""""""""""
"""""""""""""""""""""""""""""""
"""""""""""""""""""""""""""""""
