!!!!!!!!!!!!!!!!!!!!!!!!!!!!!!!!!!!!!!!!!!!!!!!!!!!!!!!!!!!!!!!!!!!!!!!!!!!!!
!!!!!!!!!!!!!!!!!!!!!!!!!!!!!!!!!!!!!!!!!!!!!!!!!!!!!!!!!!!!!!!!!!!!!!!!!!!!!
!!!!!!!!!!!!!!!!!!!!!!!!!!!!!!!!!!!!!!!!!!!!!!!!!!!!!!!!!!!!!!!!!!!!!!!!!!!!!
!!!!!!!!!!!!!!!!!!!!!!!!!!!!!!!!!!!!!!!!!!!!!!!!!!!!!!!!!!!!!!!!!!!!!!!!!!!!!
!!!!!!!!!!!!!!!!!!!!!!!!!!!!!!!!!!!!!!!!!!!!!!!!!!!!!!!!!!!!!!!!!!!!!!!!!!!!!
!!!!!"""""""""""""""""""""""""""""!!!!!!!!!!!!!!!!!!!!!"""""""""""""""""!!!!!
!!!!!"""""""""""""""""""""""""""""!!!!!!!!!!!!!!!!!!!!!"""""""""""""""""!!!!!
!!!!!"""""""""""""""""""""""""""""!!!!!!!!!!!!!!!!!!!!!"""""""""""""""""!!!!!
!!!!!"""""""""""""""""""""""""""""!!!!!!!!!!!!!!!!!!!!!""""""      """""!!!!!
!!!!!""""""""""""""""""""""""""""""""""""""""""""""""""""""""      """""!!!!!
!!!!!"""""""""""""""""""""""""""""!!!!!!!!!!!!!!!!!!!!!""""""      """""!!!!!
!!!!!"""""""""""""""""""""""""""""!!!!!!!!!!!!!!!!!!!!!"""""""""""""""""!!!!!
!!!!!"""""""""""""""""""""""""""""!!!!!!!!!!!!!!!!!!!!!"""""""""""""""""!!!!!
!!!!!"""""""""""""""""""""""""""""!!!!!!!!!!!!!!!!!!!!!"""""""""""""""""!!!!!
!!!!!!!!!!!!!!!!!!!!!!!!!!!!!!!!!!!!!!!!!!!!!!!!!!!!!!!!!!!!!!!!!!!!!!!!!!!!!
!!!!!!!!!!!!!!!!!!!!!!!!!!!!!!!!!!!!!!!!!!!!!!!!!!!!!!!!!!!!!!!!!!!!!!!!!!!!!
!!!!!!!!!!!!!!!!!!!!!!!!!!!!!!!!!!!!!!!!!!!!!!!!!!!!!!!!!!!!!!!!!!!!!!!!!!!!!
!!!!!!!!!!!!!!!!!!!!!!!!!!!!!!!!!!!!!!!!!!!!!!!!!!!!!!!!!!!!!!!!!!!!!!!!!!!!!
!!!!!!!!!!!!!!!!!!!!!!!!!!!!!!!!!!!!!!!!!!!!!!!!!!!!!!!!!!!!!!!!!!!!!!!!!!!!!
!!!!!!!!!!!!!!!!!!!!!!!!!!!!!!!!!!!!!!!!!!!!!!!!!!!!!!!!!!!!!!!!!!!!!!!!!!!!!
!!!!!!!!!!!!!!!!!!!!!!!!!!!!!!!!!!!!!!!!!!!!!!!!!!!!!!!!!!!!!!!!!!!!!!!!!!!!!
!!!!!!!!!!!!!!!!!!!!!!!!!!!!!!!!!!!!!!!!!!!!!!!!!!!!!!!!!!!!!!!!!!!!!!!!!!!!!
!!!!!!!!!!!!!!!!!!!!!!!!!!!!!!!!!!!!!!!!!!!!!!!!!!!!!!!!!!!!!!!!!!!!!!!!!!!!!
!!!!!!!!!!!!!!!!!!!!!!!!!!!!!!!!!!!!!!!!!!!!!!!!!!!!!!!!!!!!!!!!!!!!!!!!!!!!!
!!!!!                             !!!!!!!!!!!!!!!!!!!!!#################!!!!!
!!!!!                             !!!!!!!!!!!!!!!!!!!!!#               #!!!!!
!!!!!                             !!!!!!!!!!!!!!!!!!!!!#               #!!!!!
!!!!!                             ######################               #!!!!!
!!!!!                                                                  #!!!!!
!!!!!                             ######################               #!!!!!
!!!!!                             !!!!!!!!!!!!!!!!!!!!!#               #!!!!!
!!!!!                             !!!!!!!!!!!!!!!!!!!!!#               #!!!!!
!!!!!                             !!!!!!!!!!!!!!!!!!!!!#################!!!!!
!!!!!!!!!!!!!!!!!!!!!!!!!!!!!!!!!!!!!!!!!!!!!!!!!!!!!!!!!!!!!!!!!!!!!!!!!!!!!
!!!!!!!!!!!!!!!!!!!!!!!!!!!!!!!!!!!!!!!!!!!!!!!!!!!!!!!!!!!!!!!!!!!!!!!!!!!!!
!!!!!!!!!!!!!!!!!!!!!!!!!!!!!!!!!!!!!!!!!!!!!!!!!!!!!!!!!!!!!!!!!!!!!!!!!!!!!
!!!!!!!!!!!!!!!!!!!!!!!!!!!!!!!!!!!!!!!!!!!!!!!!!!!!!!!!!!!!!!!!!!!!!!!!!!!!!
!!!!!!!!!!!!!!!!!!!!!!!!!!!!!!!!!!!!!!!!!!!!!!!!!!!!!!!!!!!!!!!!!!!!!!!!!!!!!
!!!!!!!!!!!!!!!!!!!!!!!!!!!!!!!!!!!!!!!!!!!!!!!!!!!!!!!!!!!!!!!!!!!!!!!!!!!!!
!!!!!!!!!!!!!!!!!!!!!!!!!!!!!!!!!!!!!!!!!!!!!!!!!!!!!!!!!!!!!!!!!!!!!!!!!!!!!
!!!!!!!!!!!!!!!!!!!!!!!!!!!!!!!!!!!!!!!!!!!!!!!!!!!!!!!!!!!!!!!!!!!!!!!!!!!!!
!!!!!!!!!!!!!!!!!!!!!!!!!!!!!!!!!!!!!!!!!!!!!!!!!!!!!!!!!!!!!!!!!!!!!!!!!!!!!
!!!!!!!!!!!!!!!!!!!!!!!!!!!!!!!!!!!!!!!!!!!!!!!!!!!!!!!!!!!!!!!!!!!!!!!!!!!!!
!!!!!"""""""""""""""""""""""""""""!!!!!!!!!!!!!!!!!!!!!'''''''''''''''''!!!!!
!!!!!"""""""""""""""""""""""""""""!!!!!!!!!!!!!!!!!!!!!'''''''''''''''''!!!!!
!!!!!"""""""""""""""""""""""""""""!!!!!!!!!!!!!!!!!!!!!'''''''''''''''''!!!!!
!!!!!"""""""""""""""""""""""""""""!!!!!!!!!!!!!!!!!!!!!'''''''''''''''''!!!!!
!!!!!"""""""""""""""""""""""""""""''''''''''''''''''''''''''''''''''''''!!!!!
!!!!!"""""""""""""""""""""""""""""!!!!!!!!!!!!!!!!!!!!!'''''''''''''''''!!!!!
!!!!!"""""""""""""""""""""""""""""!!!!!!!!!!!!!!!!!!!!!'''''''''''''''''!!!!!
!!!!!"""""""""""""""""""""""""""""!!!!!!!!!!!!!!!!!!!!!'''''''''''''''''!!!!!
!!!!!"""""""""""""""""""""""""""""!!!!!!!!!!!!!!!!!!!!!'''''''''''''''''!!!!!
!!!!!!!!!!!!!!!!!!!!!!!!!!!!!!!!!!!!!!!!!!!!!!!!!!!!!!!!!!!!!!!!!!!!!!!!!!!!!
!!!!!!!!!!!!!!!!!!!!!!!!!!!!!!!!!!!!!!!!!!!!!!!!!!!!!!!!!!!!!!!!!!!!!!!!!!!!!
!!!!!!!!!!!!!!!!!!!!!!!!!!!!!!!!!!!!!!!!!!!!!!!!!!!!!!!!!!!!!!!!!!!!!!!!!!!!!
!!!!!!!!!!!!!!!!!!!!!!!!!!!!!!!!!!!!!!!!!!!!!!!!!!!!!!!!!!!!!!!!!!!!!!!!!!!!!
!!!!!!!!!!!!!!!!!!!!!!!!!!!!!!!!!!!!!!!!!!!!!!!!!!!!!!!!!!!!!!!!!!!!!!!!!!!!!
