!!!!!!!!!!!!!!!!!!!!!!!!!!!!!!!!!!!!!!!!!!!!!!!!!!!!!!!!!!!!!!!!!!!!!
!"""""""""""""""""""""""""""""!!!!!!!!!!!!!!!!!!!!!"""""""""""""""""!
!"""""""""""""""""""""""""""""!!!!!!!!!!!!!!!!!!!!!"""""""""""""""""!
!"""""""""""""""""""""""""""""!!!!!!!!!!!!!!!!!!!!!"""""""""""""""""!
!"""""""""""""""""""""""""""""!!!!!!!!!!!!!!!!!!!!!"""""""""""""""""!
!"""""""""""""""""""""""""""""""""""""""""""""""""""""""""""""""""""!
!"""""""""""""""""""""""""""""!!!!!!!!!!!!!!!!!!!!!"""""""""""""""""!
!"""""""""""""""""""""""""""""!!!!!!!!!!!!!!!!!!!!!"""""""""""""""""!
!"""""""""""""""""""""""""""""!!!!!!!!!!!!!!!!!!!!!"""""""""""""""""!
!"""""""""""""""""""""""""""""!!!!!!!!!!!!!!!!!!!!!"""""""""""""""""!
!!!!!!!!!!!!!!!!!!!!!!!!!!!!!!!!!!!!!!!!!!!!!!!!!!!!!!!!!!!!!!!!!!!!!
!!!!!!!!!!!!!!!!!!!!!!!!!!!!!!!!!!!!!!!!!!!!!!!!!!!!!!!!!!!!!!!!!!!!!
!#############################!!!!!!!!!!!!!!!!!!!!!#################!
!#                           #!!!!!!!!!!!!!!!!!!!!!#               #!
!#                           #!!!!!!!!!!!!!!!!!!!!!#               #!
!#                           #######################               #!
!#                                                                 #!
!#                           #######################               #!
!#                           #!!!!!!!!!!!!!!!!!!!!!#               #!
!#                           #!!!!!!!!!!!!!!!!!!!!!#               #!
!#############################!!!!!!!!!!!!!!!!!!!!!#################!
!!!!!!!!!!!!!!!!!!!!!!!!!!!!!!!!!!!!!!!!!!!!!!!!!!!!!!!!!!!!!!!!!!!!!
!!!!!!!!!!!!!!!!!!!!!!!!!!!!!!!!!!!!!!!!!!!!!!!!!!!!!!!!!!!!!!!!!!!!!
!"""""""""""""""""""""""""""""!!!!!!!!!!!!!!!!!!!!!'''''''''''''''''!
!"""""""""""""""""""""""""""""!!!!!!!!!!!!!!!!!!!!!'''''''''''''''''!
!"""""""""""""""""""""""""""""!!!!!!!!!!!!!!!!!!!!!'''''''''''''''''!
!"""""""""""""""""""""""""""""!!!!!!!!!!!!!!!!!!!!!'''''''''''''''''!
!""""""""""""""""""""""""""""'''''''''''''''''''''''''''''''''''''''!
!"""""""""""""""""""""""""""""!!!!!!!!!!!!!!!!!!!!!'''''''''''''''''!
!"""""""""""""""""""""""""""""!!!!!!!!!!!!!!!!!!!!!'''''''''''''''''!
!"""""""""""""""""""""""""""""!!!!!!!!!!!!!!!!!!!!!'''''''''''''''''!
!"""""""""""""""""""""""""""""!!!!!!!!!!!!!!!!!!!!!'''''''''''''''''!
!!!!!!!!!!!!!!!!!!!!!!!!!!!!!!!!!!!!!!!!!!!!!!!!!!!!!!!!!!!!!!!!!!!!!
