9 1
$$$$$$$$$$$$$$$$
$$$$$$$$$$$$$$$$
$$$$$$$$$$$$$$$$
$$$$$$$$$$$$$$$$
$$$$$$$$$$$$$$$$
$$$$$$$$$$$$$$$$
$$$$$$$$$$$$$$$$
$$$$$$$$$$$$$$$$
$$$$$$$$$$$$$$$$
################
#              #
#    # ####### #
#      #     # #
#      a     # #
#      #     # #
#    # ####### #
#              #
################
""""""""""""""""
""""""""""""""""
""""""""""""""""
""""""""""""""""
""!"""""""""""""
""""""""""""""""
""""""""""""""""
""""""""""""""""
""""""""""""""""
