!!!!!!!!!!!!!!!!!!!!!!!!!!!!!!!!!!!!!!!
!!!!!!!!!!!!!!!!!!!!!!!!!!!!!!!!!!!!!!!
!!!!!!!!!!!!!!!!!!!!!!!!!!!!!!!!!!!!!!!
!!!!!!!!!!!!!!!!!!!!!!!!!!!!!!!!!!!!!!!
!!!!!!!!!!!!!!!!!!!!!!!!!!!!!!!!!!!!!!!
!!!!!"""""""""""""""""""""""""""""!!!!!
!!!!!"""""""""""""""""""""""""""""!!!!!
!!!!!"""""""""""""""""""""""""""""!!!!!
!!!!!"""""""""""""""""""""""""""""!!!!!
!!!!!"""""""""""""""""""""""""""""!!!!!
!!!!!"""""""""""""""""""""""""""""!!!!!
!!!!!"""""""""""""""""""""""""""""!!!!!
!!!!!"""""""""""""""""""""""""""""!!!!!
!!!!!"""""""""""""""""""""""""""""!!!!!
!!!!!!!!!!!!!!!!!!!!!!!!!!!!!!!!!!!!!!!
!!!!!!!!!!!!!!!!!!!!!!!!!!!!!!!!!!!!!!!
!!!!!!!!!!!!!!!!!!!!!!!!!!!!!!!!!!!!!!!
!!!!!!!!!!!!!!!!!!!!!!!!!!!!!!!!!!!!!!!
!!!!!!!!!!!!!!!!!!!!!!!!!!!!!!!!!!!!!!!
!!!!!!!!!!!!!!!!!!!!!!!!!!!!!!!!!!!!!!!
!!!!!!!!!!!!!!!!!!!!!!!!!!!!!!!!!!!!!!!
!!!!!!!!!!!!!!!!!!!!!!!!!!!!!!!!!!!!!!!
!!!!!!!!!!!!!!!!!!!!!!!!!!!!!!!!!!!!!!!
!!!!!!!!!!!!!!!!!!!!!!!!!!!!!!!!!!!!!!!
!!!!!                             !!!!!
!!!!!                             !!!!!
!!!!!                             !!!!!
!!!!!                             !!!!!
!!!!!                             !!!!!
!!!!!                             !!!!!
!!!!!                             !!!!!
!!!!!                             !!!!!
!!!!!                             !!!!!
!!!!!!!!!!!!!!!!!!!!!!!!!!!!!!!!!!!!!!!
!!!!!!!!!!!!!!!!!!!!!!!!!!!!!!!!!!!!!!!
!!!!!!!!!!!!!!!!!!!!!!!!!!!!!!!!!!!!!!!
!!!!!!!!!!!!!!!!!!!!!!!!!!!!!!!!!!!!!!!
!!!!!!!!!!!!!!!!!!!!!!!!!!!!!!!!!!!!!!!
!!!!!!!!!!!!!!!!!!!!!!!!!!!!!!!!!!!!!!!
!!!!!!!!!!!!!!!!!!!!!!!!!!!!!!!!!!!!!!!
!!!!!!!!!!!!!!!!!!!!!!!!!!!!!!!!!!!!!!!
!!!!!!!!!!!!!!!!!!!!!!!!!!!!!!!!!!!!!!!
!!!!!!!!!!!!!!!!!!!!!!!!!!!!!!!!!!!!!!!
!!!!!"""""""""""""""""""""""""""""!!!!!
!!!!!"""""""""""""""""""""""""""""!!!!!
!!!!!"""""""""""""""""""""""""""""!!!!!
!!!!!"""""""""""""""""""""""""""""!!!!!
!!!!!"""""""""""""""""""""""""""""!!!!!
!!!!!"""""""""""""""""""""""""""""!!!!!
!!!!!"""""""""""""""""""""""""""""!!!!!
!!!!!"""""""""""""""""""""""""""""!!!!!
!!!!!"""""""""""""""""""""""""""""!!!!!
!!!!!!!!!!!!!!!!!!!!!!!!!!!!!!!!!!!!!!!
!!!!!!!!!!!!!!!!!!!!!!!!!!!!!!!!!!!!!!!
!!!!!!!!!!!!!!!!!!!!!!!!!!!!!!!!!!!!!!!
!!!!!!!!!!!!!!!!!!!!!!!!!!!!!!!!!!!!!!!
!!!!!!!!!!!!!!!!!!!!!!!!!!!!!!!!!!!!!!!
