!!!!!!!!!!!!!!!!!!!!!!!!!!!!!!!!!!!!!!!!!!!!!!!!!!!!!!!!!!!!!!!!!!!!!!!!!!!!!!!!!!
!!!!!!!!!!!!!!!!!!!!!!!!!!!!!!!!!!!!!!!!!!!!!!!!!!!!!!!!!!!!!!!!!!!!!!!!!!!!!!!!!!
!!##############################################################################!!
!!##############################################################################!!
!!##############################################################################!!
!!##############################################################################!!
!!##############################################################################!!
!!##############################################################################!!
!!##############################################################################!!
!!##############################################################################!!
!!##############################################################################!!
!!##############################################################################!!
!!##############################################################################!!
!!##############################################################################!!
!!##############################################################################!!
!!!!!!!!!!!!!!!!!!!!!!!!!!!!!!!!!!!!!!!!!!!!!!!!!!!!!!!!!!!!!!!!!!!!!!!!!!!!!!!!!!
!!!!!!!!!!!!!!!!!!!!!!!!!!!!!!!!!!!!!!!!!!!!!!!!!!!!!!!!!!!!!!!!!!!!!!!!!!!!!!!!!!
!!##############################################################################!!
!!#                                                                            #!!
!!#                                                                            #!!
!!#              #                                                             #!!
!!#    #                                                                       #!!
!!#                                                                            #!!
!!#                                                                            #!!
!!#                                                                            #!!
!!#                                                                            #!!
!!#                                                                            #!!
!!#                                                                            #!!
!!##############################################################################!!
!!!!!!!!!!!!!!!!!!!!!!!!!!!!!!!!!!!!!!!!!!!!!!!!!!!!!!!!!!!!!!!!!!!!!!!!!!!!!!!!!!
!!!!!!!!!!!!!!!!!!!!!!!!!!!!!!!!!!!!!!!!!!!!!!!!!!!!!!!!!!!!!!!!!!!!!!!!!!!!!!!!!!
!!##############################################################################!!
!!##############################################################################!!
!!##############################################################################!!
!!##############################################################################!!
!!####'''#######################################################################!!
!!####'''#######################################################################!!
!!####'''#######################################################################!!
!!##############################################################################!!
!!##############################################################################!!
!!##############################################################################!!
!!##############################################################################!!
!!##############################################################################!!
!!##############################################################################!!
!!!!!!!!!!!!!!!!!!!!!!!!!!!!!!!!!!!!!!!!!!!!!!!!!!!!!!!!!!!!!!!!!!!!!!!!!!!!!!!!!!
