"""""""""""""""""""""""""""""""""""""""
"""""""""""""""""""""""""""""""""""""""
"""""""""""""""""""""""""""""""""""""""
"""""""""""""""""""""""""""""""""""""""
"""""""""""""""""""""""""""""""""""""""
"""""""""""""""""""""""""""""""""""""""
"""""""""""""""""""""""""""""""""""""""
"""""""""""""""""""""""""""""""""""""""
"""""""""""""""""""""""""""""""""""""""
"""""""""""""""""""""""""""""""""""""""
"""""""""""""""""""""""""""""""""""""""
"""""""""""""""""""""""""""""""""""""""
"""""""""""""""""""""""""""""""""""""""
"""""""""""""""""""""""""""""""""""""""
"""""""""""""""""""""""""""""""""""""""
"""""""""""""""""""""""""""""""""""""""
"""""""""""""""""""""""""""""""""""""""
"""""""""""""""""""""""""""""""""""""""
"""""""""""""""""""""""""""""""""""""""
#######################################
#######################################
#######################################
#######################################
#######################################
############################# #########
#####              #########   ########
#####    # ####### ########     #######
#####      #     # #######       ######
####c      a     #                #####
#####      #     # #######       ######
#####    # ####### ########     #######
#####              #########   ########
############################# #########
#######################################
#######################################
#######################################
#######################################
#######################################
"""""""""""""""""""""""""""""""""""""""
"""""""""""""""""""""""""""""""""""""""
"""""""""""""""""""""""""""""""""""""""
"""""""""""""""""""""""""""""""""""""""
"""""""""""""""""""""""""""""""""""""""
"""""""""""""""""""""""""""""""""""""""
"""""""""""""""""""""""""""""""""""""""
"""""""""""""""""""""""""""""""""""""""
"""""""""""""""""""""""""""""""""""""""
"""""""""""""""""""""""""""""""""""""""
"""""""""""""""""""""""""""""""""""""""
"""""""""""""""""""""""""""""""""""""""
"""""""""""""""""""""""""""""""""""""""
"""""""""""""""""""""""""""""""""""""""
"""""""""""""""""""""""""""""""""""""""
"""""""""""""""""""""""""""""""""""""""
"""""""""""""""""""""""""""""""""""""""
"""""""""""""""""""""""""""""""""""""""
"""""""""""""""""""""""""""""""""""""""
