9
9
2 2 2 2 2 2 2 2 2
2 2 2 2 2 2 2 2 2
2 2 2 2 2 2 2 2 2
2 2 2 2 2 2 2 2 2
2 2 2 2 2 2 2 2 2
2 2 2 2 2 2 2 2 2
2 2 2 2 2 2 2 2 2
2 2 2 2 2 2 2 2 2
2 2 2 2 2 2 2 2 2
2 2 1 2 2 2 1 2 2
2 0 0 0 2 0 0 0 2
2 0 0 0 2 0 0 0 2
2 0 0 0 2 0 0 0 2
2 0 0 0 0 0 0 0 2
2 0 0 0 2 0 0 0 2
2 0 0 0 2 0 0 0 2
2 0 0 0 2 0 0 0 2
2 2 1 2 2 2 1 2 2
2 2 2 2 2 2 2 2 2
2 3 3 3 2 3 3 3 2
2 3 2 3 2 3 2 3 2
2 3 2 3 2 3 2 3 2
2 3 2 3 2 3 2 3 2
2 3 2 3 2 3 2 3 2
2 3 2 3 2 3 2 3 2
2 3 3 3 2 3 3 3 2
2 2 2 2 2 2 2 2 2
