1 2.5 4.5
9
$$$$$$$$$$$$$$$$
$$$$$$$$$$$$$$$$
$$$$$$$$$$$$$$$$
$$$$$$$$$$$$$$$$
$$$$$$$$$$$$$$$$
$$$$$$$$$$$$$$$$
$$$$$$$$$$$$$$$$
$$$$$$$$$$$$$$$$
$$$$$$$$$$$$$$$$
################
#              #
#      ####### #
#      #     # #
#      a     # #
#      #     # #
#      ####### #
#              #
################
""""""""""""""""
""""""""""""""""
""""""""""""""""
""""""""""""""""
""!"""""""""""""
""""""""""""""""
""""""""""""""""
""""""""""""""""
""""""""""""""""
